..........
.1s=2.1=2.
.|..4=3.|.
.4=2....|.
...4====3.
..........